//MAP CONVERTED BY dmm2tgm.py THIS HEADER COMMENT PREVENTS RECONVERSION, DO NOT REMOVE
"ac" = (
/obj/effect/turf_decal/siding/wideplating_new/dark/corner{
	dir = 4
	},
/turf/open/floor/holofloor/space,
/area/centcom/tdome/arena)
"bI" = (
/turf/open/floor/iron/dark/smooth_half{
	dir = 8
	},
/area/centcom/tdome/arena)
"fw" = (
/turf/open/floor/catwalk_floor/iron_dark,
/area/centcom/tdome/arena)
"fR" = (
/obj/effect/turf_decal/stripes/red/line{
	dir = 9
	},
/turf/open/floor/engine/air,
/area/centcom/tdome/arena)
"je" = (
/obj/effect/turf_decal/stripes/red/line{
	dir = 5
	},
/turf/open/floor/engine/air,
/area/centcom/tdome/arena)
"jV" = (
/turf/open/floor/iron/dark/smooth_half,
/area/centcom/tdome/arena)
"kV" = (
/obj/item/statuebust{
	icon = 'icons/obj/structures.dmi';
	icon_state = "hilbertshotel";
	pixel_y = -12;
	name = "anomaly";
	color = #954696
	},
/obj/effect/turf_decal/stripes/red/line{
	dir = 1
	},
/turf/open/floor/engine/air,
/area/centcom/tdome/arena)
"oj" = (
/obj/effect/turf_decal/stripes/red/line{
	dir = 6
	},
/turf/open/floor/engine/air,
/area/centcom/tdome/arena)
"qv" = (
/obj/effect/turf_decal/siding/wideplating_new/dark/corner{
	dir = 8
	},
/turf/open/floor/holofloor/space,
/area/centcom/tdome/arena)
"uq" = (
/obj/effect/turf_decal/siding/wideplating_new/dark{
	dir = 8
	},
/turf/open/floor/holofloor/space,
/area/centcom/tdome/arena)
"vE" = (
/obj/effect/turf_decal/siding/wideplating_new/dark,
/turf/open/floor/holofloor/space,
/area/centcom/tdome/arena)
"yb" = (
/obj/effect/turf_decal/siding/wideplating_new/dark/corner{
	dir = 1
	},
/turf/open/floor/holofloor/space,
/area/centcom/tdome/arena)
"Bq" = (
/obj/effect/turf_decal/siding/wideplating_new/dark/corner,
/turf/open/floor/holofloor/space,
/area/centcom/tdome/arena)
"El" = (
/obj/effect/turf_decal/stripes/red/line,
/turf/open/floor/engine/air,
/area/centcom/tdome/arena)
"Gr" = (
/turf/open/floor/bluespace,
/area/centcom/tdome/arena)
"Lr" = (
/obj/effect/turf_decal/siding/wideplating_new/dark{
	dir = 1
	},
/turf/open/floor/holofloor/space,
/area/centcom/tdome/arena)
"NU" = (
/turf/open/floor/iron/dark/smooth_corner{
	dir = 1
	},
/area/centcom/tdome/arena)
"TR" = (
/obj/effect/turf_decal/siding/wideplating_new/dark{
	dir = 4
	},
/turf/open/floor/holofloor/space,
/area/centcom/tdome/arena)
"UC" = (
/turf/open/floor/iron/dark/smooth_corner{
	dir = 8
	},
/area/centcom/tdome/arena)
"Vh" = (
/turf/open/floor/iron/dark/smooth_corner{
	dir = 4
	},
/area/centcom/tdome/arena)
"WN" = (
/turf/open/floor/iron/dark/smooth_corner,
/area/centcom/tdome/arena)
"YE" = (
/turf/open/floor/iron/dark/smooth_large,
/area/centcom/tdome/arena)
"ZE" = (
/obj/effect/turf_decal/stripes/red/line{
	dir = 10
	},
/turf/open/floor/engine/air,
/area/centcom/tdome/arena)

(1,1,1) = {"
Bq
TR
TR
TR
TR
TR
TR
TR
TR
ac
"}
(2,1,1) = {"
vE
YE
YE
YE
YE
YE
YE
YE
YE
Lr
"}
(3,1,1) = {"
vE
YE
Gr
Gr
fw
fw
Gr
Gr
YE
Lr
"}
(4,1,1) = {"
vE
YE
Gr
WN
bI
bI
Vh
Gr
YE
Lr
"}
(5,1,1) = {"
vE
YE
fw
jV
YE
YE
jV
fw
YE
Lr
"}
(6,1,1) = {"
vE
YE
fw
jV
YE
YE
jV
fw
YE
Lr
"}
(7,1,1) = {"
vE
YE
Gr
UC
bI
bI
NU
Gr
YE
Lr
"}
(8,1,1) = {"
vE
YE
Gr
Gr
oj
je
Gr
Gr
YE
Lr
"}
(9,1,1) = {"
vE
YE
Gr
Gr
kV
El
Gr
Gr
YE
Lr
"}
(10,1,1) = {"
vE
YE
Gr
Gr
ZE
fR
Gr
Gr
YE
Lr
"}
(11,1,1) = {"
vE
YE
Gr
WN
bI
bI
Vh
Gr
YE
Lr
"}
(12,1,1) = {"
vE
YE
fw
jV
YE
YE
jV
fw
YE
Lr
"}
(13,1,1) = {"
vE
YE
fw
jV
YE
YE
jV
fw
YE
Lr
"}
(14,1,1) = {"
vE
YE
Gr
UC
bI
bI
NU
Gr
YE
Lr
"}
(15,1,1) = {"
vE
YE
Gr
Gr
fw
fw
Gr
Gr
YE
Lr
"}
(16,1,1) = {"
vE
YE
YE
YE
YE
YE
YE
YE
YE
Lr
"}
(17,1,1) = {"
qv
uq
uq
uq
uq
uq
uq
uq
uq
yb
"}
