//MAP CONVERTED BY dmm2tgm.py THIS HEADER COMMENT PREVENTS RECONVERSION, DO NOT REMOVE
"ap" = (
/obj/effect/decal/cleanable/dirt/dust,
/obj/effect/turf_decal/trimline/dark/corner{
	dir = 8
	},
/turf/open/floor/stone,
/area/centcom/tdome/arena)
"aT" = (
/obj/effect/turf_decal/siding/thinplating_new/dark,
/obj/effect/turf_decal/trimline/dark,
/obj/structure/fluff/big_chain{
	pixel_y = 12
	},
/turf/open/floor/iron/dark/textured,
/area/centcom/tdome/arena)
"bo" = (
/obj/effect/turf_decal/siding/thinplating_new/dark/corner{
	dir = 4
	},
/obj/effect/turf_decal/siding/thinplating_new/dark{
	dir = 8
	},
/turf/open/floor/iron/dark/textured,
/area/centcom/tdome/arena)
"bJ" = (
/obj/effect/decal/cleanable/dirt/dust,
/obj/item/clothing/mask/cigarette/cigar{
	pixel_x = 7;
	pixel_y = 3
	},
/obj/effect/turf_decal/trimline/dark/corner{
	dir = 4
	},
/turf/open/floor/stone,
/area/centcom/tdome/arena)
"bY" = (
/obj/effect/turf_decal/siding/thinplating_new/dark{
	dir = 8
	},
/obj/effect/turf_decal/siding/thinplating_new/dark{
	dir = 4
	},
/obj/structure/fluff/big_chain{
	pixel_y = 12
	},
/obj/effect/turf_decal/trimline/dark,
/turf/open/floor/iron/dark/textured,
/area/centcom/tdome/arena)
"cc" = (
/obj/effect/decal/cleanable/dirt,
/obj/effect/turf_decal/trimline/dark/corner{
	dir = 1
	},
/obj/effect/turf_decal/trimline/dark/corner{
	dir = 4
	},
/turf/open/floor/stone,
/area/centcom/tdome/arena)
"cm" = (
/obj/structure/table,
/turf/open/floor/stone,
/area/centcom/tdome/arena)
"cs" = (
/obj/effect/decal/cleanable/dirt/dust,
/obj/effect/turf_decal/siding/thinplating_new/dark{
	dir = 6
	},
/obj/effect/decal/cleanable/blood/old,
/turf/open/floor/iron/dark/textured,
/area/centcom/tdome/arena)
"cS" = (
/obj/effect/turf_decal/siding/thinplating_new/dark/corner{
	dir = 8
	},
/obj/effect/turf_decal/siding/thinplating_new/dark{
	dir = 5
	},
/turf/open/floor/iron/dark/textured,
/area/centcom/tdome/arena)
"dy" = (
/obj/effect/turf_decal/siding/thinplating_new/dark/corner{
	dir = 8
	},
/obj/effect/turf_decal/siding/thinplating_new/dark/corner,
/obj/effect/decal/cleanable/dirt/dust,
/turf/open/floor/iron/dark/textured,
/area/centcom/tdome/arena)
"fp" = (
/obj/effect/turf_decal/siding/thinplating_new/dark{
	dir = 1
	},
/obj/structure/fluff/big_chain{
	pixel_y = 12
	},
/obj/effect/turf_decal/trimline/dark,
/turf/open/floor/iron/dark/textured,
/area/centcom/tdome/arena)
"ft" = (
/obj/effect/turf_decal/trimline/dark/warning,
/turf/open/floor/stone,
/area/centcom/tdome/arena)
"fw" = (
/obj/effect/turf_decal/trimline/dark/warning{
	dir = 10
	},
/turf/open/floor/stone,
/area/centcom/tdome/arena)
"fB" = (
/obj/effect/decal/cleanable/blood/old,
/obj/effect/turf_decal/trimline/dark/corner{
	dir = 1
	},
/turf/open/floor/stone,
/area/centcom/tdome/arena)
"ie" = (
/obj/effect/decal/cleanable/dirt,
/obj/effect/turf_decal/trimline/dark/warning{
	dir = 4
	},
/obj/effect/turf_decal/trimline/dark/warning{
	dir = 8
	},
/turf/open/floor/stone,
/area/centcom/tdome/arena)
"iW" = (
/obj/effect/turf_decal/siding/thinplating_new/dark{
	dir = 6
	},
/obj/effect/turf_decal/siding/thinplating_new/dark/corner{
	dir = 1
	},
/turf/open/floor/iron/dark/textured,
/area/centcom/tdome/arena)
"jg" = (
/obj/effect/turf_decal/siding/thinplating_new/dark,
/obj/effect/turf_decal/siding/thinplating_new/dark/corner{
	dir = 1
	},
/obj/effect/turf_decal/caution/white{
	dir = 1
	},
/turf/open/floor/iron/dark/textured,
/area/centcom/tdome/arena)
"jp" = (
/obj/effect/turf_decal/siding/thinplating_new/dark/corner{
	dir = 1
	},
/obj/effect/turf_decal/siding/thinplating_new/dark{
	dir = 6
	},
/turf/open/floor/iron/dark/textured,
/area/centcom/tdome/arena)
"jq" = (
/obj/effect/turf_decal/siding/thinplating_new/dark{
	dir = 1
	},
/obj/effect/decal/cleanable/blood/old,
/turf/open/floor/iron/dark/textured,
/area/centcom/tdome/arena)
"jt" = (
/obj/effect/turf_decal/siding/thinplating_new/dark{
	dir = 1
	},
/obj/effect/turf_decal/siding/thinplating_new/dark/corner{
	dir = 8
	},
/obj/effect/turf_decal/caution/white,
/turf/open/floor/iron/dark/textured,
/area/centcom/tdome/arena)
"jy" = (
/obj/effect/turf_decal/siding/thinplating_new/dark/corner{
	dir = 8
	},
/obj/effect/decal/cleanable/dirt/dust,
/obj/effect/turf_decal/siding/thinplating_new/dark{
	dir = 5
	},
/turf/open/floor/iron/dark/textured,
/area/centcom/tdome/arena)
"kr" = (
/obj/effect/turf_decal/siding/thinplating_new/dark{
	dir = 4
	},
/obj/effect/turf_decal/siding/thinplating_new/dark{
	dir = 8
	},
/turf/open/floor/iron/dark/textured,
/area/centcom/tdome/arena)
"kw" = (
/obj/structure/lattice/catwalk,
/turf/open/floor/catwalk_floor/iron_dark,
/area/centcom/tdome/arena)
"kx" = (
/obj/effect/turf_decal/siding/thinplating_new/dark{
	dir = 10
	},
/obj/effect/turf_decal/siding/thinplating_new/dark/corner{
	dir = 4
	},
/turf/open/floor/iron/dark/textured,
/area/centcom/tdome/arena)
"kI" = (
/obj/effect/decal/cleanable/dirt/dust,
/obj/structure/table/reinforced,
/turf/open/floor/stone,
/area/centcom/tdome/arena)
"kU" = (
/obj/effect/turf_decal/siding/thinplating_new/dark,
/turf/open/floor/iron/dark/textured,
/area/centcom/tdome/arena)
"lk" = (
/obj/effect/turf_decal/siding/thinplating_new/dark/corner,
/obj/effect/turf_decal/siding/thinplating_new/dark/corner{
	dir = 8
	},
/obj/effect/turf_decal/siding/thinplating_new/dark{
	dir = 1
	},
/turf/open/floor/iron/dark/textured,
/area/centcom/tdome/arena)
"lq" = (
/obj/effect/turf_decal/siding/thinplating_new/dark{
	dir = 1
	},
/obj/effect/turf_decal/siding/thinplating_new/dark/corner{
	dir = 8
	},
/obj/effect/decal/cleanable/blood/old,
/turf/open/floor/iron/dark/textured,
/area/centcom/tdome/arena)
"mG" = (
/obj/effect/turf_decal/siding/thinplating_new/dark{
	dir = 1
	},
/obj/effect/turf_decal/siding/thinplating_new/dark,
/obj/effect/turf_decal/trimline/dark,
/obj/structure/fluff/big_chain{
	pixel_y = 12
	},
/turf/open/floor/iron/dark/textured,
/area/centcom/tdome/arena)
"mI" = (
/obj/item/ammo_casing,
/obj/item/ammo_casing{
	pixel_x = -9;
	pixel_y = -15
	},
/obj/effect/turf_decal/trimline/dark/warning{
	dir = 8
	},
/turf/open/floor/stone,
/area/centcom/tdome/arena)
"mM" = (
/obj/effect/turf_decal/siding/thinplating_new/dark{
	dir = 1
	},
/turf/open/floor/iron/dark/textured,
/area/centcom/tdome/arena)
"nu" = (
/obj/effect/turf_decal/siding/thinplating_new/dark/corner{
	dir = 1
	},
/obj/effect/turf_decal/siding/thinplating_new/dark/corner{
	dir = 4
	},
/obj/effect/turf_decal/siding/thinplating_new/dark,
/turf/open/floor/iron/dark/textured,
/area/centcom/tdome/arena)
"nP" = (
/obj/effect/turf_decal/siding/thinplating_new/dark,
/obj/effect/turf_decal/siding/thinplating_new/dark/corner{
	dir = 4
	},
/obj/effect/turf_decal/caution/white{
	dir = 1
	},
/turf/open/floor/iron/dark/textured,
/area/centcom/tdome/arena)
"nR" = (
/obj/effect/turf_decal/siding/thinplating_new/dark,
/obj/effect/turf_decal/siding/thinplating_new/dark{
	dir = 1
	},
/turf/open/floor/iron/dark/textured,
/area/centcom/tdome/arena)
"oG" = (
/obj/effect/decal/cleanable/dirt/dust,
/obj/item/stack/spacecash/c50{
	pixel_y = 9
	},
/obj/effect/turf_decal/trimline/dark/warning{
	dir = 4
	},
/obj/effect/turf_decal/trimline/dark/warning{
	dir = 8
	},
/turf/open/floor/stone,
/area/centcom/tdome/arena)
"oR" = (
/obj/effect/turf_decal/siding/thinplating_new/dark,
/obj/effect/turf_decal/siding/thinplating_new/dark/corner{
	dir = 4
	},
/obj/effect/decal/cleanable/blood/old,
/turf/open/floor/iron/dark/textured,
/area/centcom/tdome/arena)
"ql" = (
/obj/effect/turf_decal/siding/thinplating_new/dark/corner{
	dir = 8
	},
/obj/effect/turf_decal/siding/thinplating_new/dark/corner,
/obj/effect/turf_decal/siding/thinplating_new/dark{
	dir = 1
	},
/turf/open/floor/iron/dark/textured,
/area/centcom/tdome/arena)
"qn" = (
/obj/effect/turf_decal/trimline/dark/warning{
	dir = 6
	},
/turf/open/floor/stone,
/area/centcom/tdome/arena)
"qq" = (
/obj/effect/decal/cleanable/dirt/dust,
/obj/item/clothing/head/fedora,
/obj/effect/turf_decal/trimline/dark/warning{
	dir = 4
	},
/turf/open/floor/stone,
/area/centcom/tdome/arena)
"qx" = (
/obj/effect/decal/cleanable/dirt,
/obj/effect/turf_decal/trimline/dark/corner{
	dir = 1
	},
/turf/open/floor/stone,
/area/centcom/tdome/arena)
"qH" = (
/obj/effect/turf_decal/siding/thinplating_new/dark{
	dir = 9
	},
/obj/effect/turf_decal/siding/thinplating_new/dark/corner,
/turf/open/floor/iron/dark/textured,
/area/centcom/tdome/arena)
"rD" = (
/obj/effect/turf_decal/trimline/dark/warning{
	dir = 4
	},
/turf/open/floor/stone,
/area/centcom/tdome/arena)
"sb" = (
/obj/effect/decal/cleanable/dirt,
/obj/effect/turf_decal/trimline/dark/warning{
	dir = 4
	},
/turf/open/floor/stone,
/area/centcom/tdome/arena)
"sk" = (
/obj/effect/decal/cleanable/dirt/dust,
/obj/item/clothing/head/cone{
	pixel_x = -8;
	pixel_y = 1
	},
/obj/effect/decal/cleanable/blood/old,
/obj/effect/decal/cleanable/crayon{
	icon_state = "body";
	pixel_y = 24
	},
/turf/open/floor/stone,
/area/centcom/tdome/arena)
"tI" = (
/obj/effect/turf_decal/siding/thinplating_new/dark{
	dir = 8
	},
/obj/effect/turf_decal/siding/thinplating_new/dark{
	dir = 4
	},
/turf/open/floor/iron/dark/textured,
/area/centcom/tdome/arena)
"tL" = (
/obj/effect/turf_decal/siding/thinplating_new/dark{
	dir = 5
	},
/turf/open/floor/iron/dark/textured,
/area/centcom/tdome/arena)
"tV" = (
/obj/effect/turf_decal/trimline/dark/warning{
	dir = 1
	},
/turf/open/floor/stone,
/area/centcom/tdome/arena)
"uj" = (
/obj/effect/turf_decal/siding/thinplating_new/dark{
	dir = 5
	},
/obj/effect/decal/cleanable/dirt/dust,
/turf/open/floor/iron/dark/textured,
/area/centcom/tdome/arena)
"uQ" = (
/obj/effect/turf_decal/siding/thinplating_new/dark,
/obj/effect/decal/cleanable/crayon{
	icon_state = "3";
	pixel_x = -10
	},
/turf/open/floor/iron/dark/textured,
/area/centcom/tdome/arena)
"vs" = (
/obj/effect/turf_decal/siding/thinplating_new/dark,
/obj/effect/decal/cleanable/dirt/dust,
/obj/effect/decal/cleanable/blood/old,
/turf/open/floor/iron/dark/textured,
/area/centcom/tdome/arena)
"vJ" = (
/obj/effect/turf_decal/siding/thinplating_new/dark{
	dir = 1
	},
/obj/effect/turf_decal/caution/white,
/turf/open/floor/iron/dark/textured,
/area/centcom/tdome/arena)
"vK" = (
/obj/structure/lattice/catwalk,
/obj/effect/turf_decal/siding/thinplating_new/dark{
	dir = 8
	},
/turf/open/floor/catwalk_floor/iron_dark,
/area/centcom/tdome/arena)
"vS" = (
/obj/effect/turf_decal/siding/thinplating_new/dark{
	dir = 1
	},
/obj/effect/turf_decal/siding/thinplating_new/dark/corner,
/obj/effect/turf_decal/trimline/dark,
/obj/structure/fluff/big_chain{
	pixel_y = 12
	},
/turf/open/floor/iron/dark/textured,
/area/centcom/tdome/arena)
"wi" = (
/obj/structure/chair/sofa/corp/right{
	dir = 4;
	pixel_x = -5
	},
/obj/effect/turf_decal/trimline/dark/warning{
	dir = 8
	},
/turf/open/floor/stone,
/area/centcom/tdome/arena)
"ww" = (
/obj/effect/turf_decal/siding/thinplating_new/dark/corner{
	dir = 8
	},
/obj/effect/turf_decal/siding/thinplating_new/dark{
	dir = 4
	},
/obj/item/stack/sheet/mineral/diamond{
	pixel_x = 7;
	pixel_y = -6
	},
/turf/open/floor/iron/dark/textured,
/area/centcom/tdome/arena)
"xr" = (
/obj/effect/turf_decal/siding/thinplating_new/dark{
	dir = 1
	},
/obj/effect/decal/cleanable/blood/old,
/obj/effect/turf_decal/trimline/dark,
/obj/structure/fluff/big_chain{
	pixel_y = 12
	},
/turf/open/floor/iron/dark/textured,
/area/centcom/tdome/arena)
"yb" = (
/obj/item/toy/crayon/white{
	pixel_x = 17
	},
/obj/effect/turf_decal/trimline/dark/warning,
/turf/open/floor/stone,
/area/centcom/tdome/arena)
"AZ" = (
/obj/effect/turf_decal/siding/thinplating_new/dark{
	dir = 9
	},
/turf/open/floor/iron/dark/textured,
/area/centcom/tdome/arena)
"BJ" = (
/obj/effect/decal/cleanable/dirt,
/obj/effect/turf_decal/trimline/dark/warning{
	dir = 9
	},
/turf/open/floor/stone,
/area/centcom/tdome/arena)
"BU" = (
/obj/effect/turf_decal/siding/thinplating_new/dark/corner,
/obj/effect/turf_decal/siding/thinplating_new/dark{
	dir = 8
	},
/obj/effect/turf_decal/trimline/dark,
/obj/structure/fluff/big_chain{
	pixel_y = 12
	},
/turf/open/floor/iron/dark/textured,
/area/centcom/tdome/arena)
"Cm" = (
/obj/effect/turf_decal/siding/thinplating_new/dark/corner{
	dir = 1
	},
/obj/effect/turf_decal/siding/thinplating_new/dark{
	dir = 4
	},
/obj/structure/fluff/big_chain{
	pixel_y = 12
	},
/obj/effect/turf_decal/trimline/dark,
/turf/open/floor/iron/dark/textured,
/area/centcom/tdome/arena)
"CX" = (
/obj/effect/turf_decal/siding/thinplating_new/dark/corner{
	dir = 8
	},
/obj/effect/turf_decal/siding/thinplating_new/dark/corner,
/turf/open/floor/iron/dark/textured,
/area/centcom/tdome/arena)
"Du" = (
/obj/effect/decal/cleanable/dirt/dust,
/obj/item/ammo_casing,
/turf/open/floor/stone,
/area/centcom/tdome/arena)
"Dv" = (
/obj/effect/decal/cleanable/blood/old,
/turf/closed/wall{
	opacity = 0
	},
/area/centcom/tdome/arena)
"DA" = (
/obj/effect/turf_decal/siding/thinplating_new/dark,
/obj/effect/decal/cleanable/dirt/dust,
/obj/effect/turf_decal/caution/white{
	dir = 1
	},
/turf/open/floor/iron/dark/textured,
/area/centcom/tdome/arena)
"Fq" = (
/obj/effect/turf_decal/trimline/dark/corner,
/turf/open/floor/stone,
/area/centcom/tdome/arena)
"Fw" = (
/obj/effect/turf_decal/siding/thinplating_new/dark,
/obj/effect/decal/cleanable/crayon{
	icon_state = "2";
	pixel_x = -11;
	pixel_y = -5
	},
/obj/effect/decal/cleanable/crayon{
	icon_state = "2";
	pixel_x = 11;
	pixel_y = -1
	},
/obj/effect/decal/cleanable/crayon{
	icon_state = "o";
	pixel_y = -3
	},
/turf/open/floor/iron/dark/textured,
/area/centcom/tdome/arena)
"FX" = (
/obj/effect/decal/cleanable/dirt/dust,
/obj/item/clothing/head/cone{
	pixel_x = 6;
	pixel_y = 6
	},
/turf/open/floor/stone,
/area/centcom/tdome/arena)
"Gq" = (
/obj/effect/decal/cleanable/dirt/dust,
/turf/open/floor/stone,
/area/centcom/tdome/arena)
"GE" = (
/obj/effect/decal/cleanable/dirt/dust,
/obj/item/toy/gun{
	pixel_x = 11;
	pixel_y = 12
	},
/obj/item/ammo_casing{
	pixel_x = 15
	},
/obj/effect/turf_decal/trimline/dark/warning{
	dir = 8
	},
/turf/open/floor/stone,
/area/centcom/tdome/arena)
"HK" = (
/obj/structure/closet/body_bag,
/obj/effect/turf_decal/trimline/dark/corner{
	dir = 4
	},
/turf/open/floor/stone,
/area/centcom/tdome/arena)
"Is" = (
/turf/open/floor/stone,
/area/centcom/tdome/arena)
"It" = (
/obj/effect/decal/cleanable/dirt/dust,
/turf/closed/wall{
	opacity = 0
	},
/area/centcom/tdome/arena)
"Iw" = (
/obj/item/clothing/head/cone{
	pixel_x = -2;
	pixel_y = -18
	},
/obj/effect/decal/cleanable/crayon{
	icon_state = "toolbox";
	pixel_x = -2;
	pixel_y = 3
	},
/turf/open/floor/stone,
/area/centcom/tdome/arena)
"IQ" = (
/obj/effect/turf_decal/siding/thinplating_new/dark,
/obj/effect/turf_decal/caution/white{
	dir = 1
	},
/turf/open/floor/iron/dark/textured,
/area/centcom/tdome/arena)
"IY" = (
/obj/structure/chair/sofa/corp/left{
	dir = 4;
	pixel_x = -5
	},
/obj/effect/turf_decal/trimline/dark/warning{
	dir = 8
	},
/turf/open/floor/stone,
/area/centcom/tdome/arena)
"Jr" = (
/obj/effect/turf_decal/siding/thinplating_new/dark{
	dir = 6
	},
/turf/open/floor/iron/dark/textured,
/area/centcom/tdome/arena)
"JH" = (
/obj/effect/turf_decal/siding/thinplating_new/dark/corner{
	dir = 1
	},
/obj/effect/decal/cleanable/dirt/dust,
/obj/effect/turf_decal/siding/thinplating_new/dark{
	dir = 6
	},
/obj/effect/turf_decal/trimline/dark,
/obj/structure/fluff/big_chain{
	pixel_y = 12
	},
/turf/open/floor/iron/dark/textured,
/area/centcom/tdome/arena)
"Kr" = (
/obj/structure/lattice/catwalk,
/obj/structure/fans/tiny,
/turf/open/floor/catwalk_floor,
/area/centcom/tdome/arena)
"Kw" = (
/obj/effect/decal/cleanable/dirt/dust,
/obj/effect/turf_decal/trimline/dark/warning{
	dir = 4
	},
/obj/effect/turf_decal/trimline/dark/warning{
	dir = 8
	},
/turf/open/floor/stone,
/area/centcom/tdome/arena)
"Li" = (
/obj/effect/turf_decal/siding/thinplating_new/dark{
	dir = 1
	},
/obj/effect/turf_decal/siding/thinplating_new/dark,
/turf/open/floor/iron/dark/textured,
/area/centcom/tdome/arena)
"Lp" = (
/obj/effect/turf_decal/siding/thinplating_new/dark/corner{
	dir = 4
	},
/obj/effect/turf_decal/siding/thinplating_new/dark{
	dir = 10
	},
/turf/open/floor/iron/dark/textured,
/area/centcom/tdome/arena)
"Mr" = (
/obj/effect/turf_decal/siding/thinplating_new/dark{
	dir = 4
	},
/obj/effect/turf_decal/siding/thinplating_new/dark{
	dir = 8
	},
/obj/structure/fluff/big_chain{
	pixel_y = 12
	},
/obj/effect/turf_decal/trimline/dark,
/turf/open/floor/iron/dark/textured,
/area/centcom/tdome/arena)
"NS" = (
/obj/effect/turf_decal/siding/thinplating_new/dark/corner{
	dir = 4
	},
/obj/effect/turf_decal/siding/thinplating_new/dark/corner{
	dir = 1
	},
/turf/open/floor/iron/dark/textured,
/area/centcom/tdome/arena)
"Pe" = (
/obj/effect/decal/cleanable/dirt/dust,
/obj/effect/turf_decal/trimline/dark/corner,
/obj/effect/turf_decal/trimline/dark/corner{
	dir = 8
	},
/turf/open/floor/stone,
/area/centcom/tdome/arena)
"Qh" = (
/obj/effect/turf_decal/siding/thinplating_new/dark{
	dir = 5
	},
/obj/effect/decal/cleanable/dirt/dust,
/obj/effect/turf_decal/siding/thinplating_new/dark/corner{
	dir = 8
	},
/turf/open/floor/iron/dark/textured,
/area/centcom/tdome/arena)
"Qu" = (
/obj/effect/decal/cleanable/dirt/dust,
/obj/structure/sign/poster/contraband/blood_geometer{
	pixel_x = 1;
	pixel_y = -16
	},
/turf/closed/wall{
	opacity = 0
	},
/area/centcom/tdome/arena)
"RO" = (
/obj/effect/decal/cleanable/dirt/dust,
/obj/structure/safe,
/obj/effect/turf_decal/trimline/dark/warning{
	dir = 4
	},
/obj/effect/turf_decal/trimline/dark/warning{
	dir = 8
	},
/turf/open/floor/stone,
/area/centcom/tdome/arena)
"RP" = (
/obj/item/clothing/head/cone{
	pixel_x = 3;
	pixel_y = -6
	},
/turf/open/floor/stone,
/area/centcom/tdome/arena)
"RU" = (
/obj/effect/turf_decal/siding/thinplating_new/dark/corner,
/obj/effect/turf_decal/siding/thinplating_new/dark{
	dir = 9
	},
/turf/open/floor/iron/dark/textured,
/area/centcom/tdome/arena)
"SA" = (
/obj/effect/turf_decal/siding/thinplating_new/dark{
	dir = 1
	},
/obj/effect/decal/cleanable/dirt/dust,
/obj/effect/turf_decal/trimline/dark,
/obj/structure/fluff/big_chain{
	pixel_y = 12
	},
/turf/open/floor/iron/dark/textured,
/area/centcom/tdome/arena)
"SY" = (
/obj/structure/table_frame,
/turf/open/floor/stone,
/area/centcom/tdome/arena)
"Tn" = (
/obj/effect/decal/cleanable/dirt/dust,
/obj/effect/turf_decal/trimline/dark/corner,
/turf/open/floor/stone,
/area/centcom/tdome/arena)
"Tz" = (
/obj/effect/decal/cleanable/dirt,
/obj/effect/turf_decal/trimline/dark/warning{
	dir = 5
	},
/turf/open/floor/stone,
/area/centcom/tdome/arena)
"TS" = (
/obj/effect/turf_decal/siding/thinplating_new/dark{
	dir = 10
	},
/turf/open/floor/iron/dark/textured,
/area/centcom/tdome/arena)
"UO" = (
/obj/effect/turf_decal/siding/thinplating_new/dark,
/obj/effect/decal/cleanable/dirt/dust,
/turf/open/floor/iron/dark/textured,
/area/centcom/tdome/arena)
"VS" = (
/obj/effect/decal/cleanable/dirt/dust,
/obj/effect/decal/cleanable/crayon{
	icon_state = "Tunnel";
	pixel_y = 16
	},
/turf/closed/wall{
	opacity = 0
	},
/area/centcom/tdome/arena)
"WI" = (
/obj/effect/turf_decal/siding/thinplating_new/dark/corner{
	dir = 1
	},
/obj/effect/turf_decal/siding/thinplating_new/dark/corner{
	dir = 4
	},
/turf/open/floor/iron/dark/textured,
/area/centcom/tdome/arena)
"XY" = (
/obj/effect/turf_decal/siding/thinplating_new/dark{
	dir = 1
	},
/obj/effect/turf_decal/siding/thinplating_new/dark,
/obj/effect/decal/cleanable/blood/old,
/turf/open/floor/iron/dark/textured,
/area/centcom/tdome/arena)
"Yg" = (
/obj/effect/turf_decal/siding/thinplating_new/dark{
	dir = 1
	},
/obj/effect/turf_decal/siding/thinplating_new/dark/corner,
/obj/effect/turf_decal/caution/white,
/turf/open/floor/iron/dark/textured,
/area/centcom/tdome/arena)
"YE" = (
/obj/effect/turf_decal/siding/thinplating_new/dark,
/obj/effect/turf_decal/siding/thinplating_new/dark/corner{
	dir = 1
	},
/turf/open/floor/iron/dark/textured,
/area/centcom/tdome/arena)
"Za" = (
/obj/effect/decal/cleanable/dirt/dust,
/obj/effect/decal/cleanable/blood/old,
/turf/open/floor/stone,
/area/centcom/tdome/arena)

(1,1,1) = {"
Fw
Kr
kw
Li
Tz
qn
nR
kw
kw
jq
"}
(2,1,1) = {"
uQ
kw
qH
JH
Is
Is
jy
kx
Kr
SA
"}
(3,1,1) = {"
aT
kw
XY
Fq
qq
rD
bJ
nR
kw
mM
"}
(4,1,1) = {"
dy
tI
nu
yb
Qu
Dv
tV
ql
bY
WI
"}
(5,1,1) = {"
UO
vK
Li
ap
mI
GE
qx
nR
kw
mM
"}
(6,1,1) = {"
IQ
Kr
jt
TS
Du
Is
AZ
jg
Kr
vJ
"}
(7,1,1) = {"
kU
vK
vS
cs
cm
Gq
uj
oR
kw
mM
"}
(8,1,1) = {"
ww
tI
jp
kI
RP
Is
SY
cS
tI
Cm
"}
(9,1,1) = {"
RO
oG
cc
Is
FX
sk
Is
Pe
ie
Kw
"}
(10,1,1) = {"
BU
kr
Lp
SY
Iw
Gq
kI
RU
kr
bo
"}
(11,1,1) = {"
kU
kw
lq
TS
Gq
cm
AZ
YE
kw
xr
"}
(12,1,1) = {"
DA
Kr
Yg
Jr
Is
Za
tL
nP
Kr
vJ
"}
(13,1,1) = {"
kU
kw
mG
Tn
rD
sb
HK
nR
kw
mM
"}
(14,1,1) = {"
CX
tI
nu
ft
It
VS
tV
lk
Mr
NS
"}
(15,1,1) = {"
aT
kw
Li
ap
IY
wi
fB
nR
Kr
mM
"}
(16,1,1) = {"
kU
kw
Qh
Lp
Is
Gq
RU
iW
kw
mM
"}
(17,1,1) = {"
vs
kw
Kr
Li
BJ
fw
nR
kw
kw
fp
"}
